############
#OOOOOOOOOO#
#OOOOOOOO$$#
#$$$O~O~$$~#
#OO~O~$]~~~#
#**********#
#~~~~~~~~~P#
#~~~~~~~~~~#
#~~~~~~~~~~#
#~~~~~~****#
############