############
#***O***O*$#
#***OOP**~##
#$$$#******#
#OO*O*$]***#
#**********#
#**********#
#**********#
#**********#
#**********#
############